0;0;0;0;0;0;0;0
0;0;0;0;0;0;0;0
0;0;0;0;0;0;0;0
0;0;0;0;0;0;0;0
0;0;0;0;A;0;0;0
0;0;A;W;?;K;0;0
0;0;W;I;A;T;0;0
0;K;?;L;A;S;0;0

coœ pachn¹cego:

KWIAT;KAWA;LAS;
C;R