0;0;0;0;0;0;0;0
0;0;0;0;0;0;0;0
0;0;0;0;0;0;0;0
0;0;0;0;0;0;0;0
0;0;0;0;0;0;0;0
0;0;a;w;a;k;0;0
0;0;w;i;a;t;0;0
0;k;?;l;a;s;0;0

coœ pachn¹cego:

kwiat;kawa;las
c