0;0;0;0;0;0;0;0
0;0;0;0;0;0;0;0
E;0;B;R;A;0;I;0
A;B;O;S;S;0;T;0
?;W;T;Y;G;E;O;0
G;E;P;0;B;R;K;P
K;A;R;A;?;Y;Y;S
M;Y;S;Z;R;D;K;?

zwierzêta:
GEPARD;RAK;MYSZ,BYK,TYGRYS,KOT,PIES,SOWA,ZEBRA
I;P,M

KARA