0;0;0;0;0;N;L;0
M;Y;D;0;O;I;U;0
P;Z;Y;£;S;K;S;0
A;L;W;S;E;L;T;C
S;E;A;N;D;E;?;A
T;W;N;A;E;F;R;D
A;R;N;R;S;A;O;O
P;?;A;K;Z;K;I;W

w ³azience:

WANNA;KRAN;PRYSZNIC;KAFELKI;MYD£O;SEDES;PASTA;LUSTRO;WODA;ZLEW;
G;L