 ;
A;M;L;E;0;0;0;M
H;A;K;?;0;0;0;S
C;K;A;Z;0;0;0;?
U;W;Z;K;0;0;0;K
L;I;Y;E;0;T;0;Y
E;L;R;Z;A;O;0;C
I;O;G;Ó;K;O;A;O
P;K;E;W;C;?;M;K

dla bobasa:

SMOCZEK;PIELUCHA;KOCYK;WÓZEK;MLEKO;GRYZAK;OLIWKA;MATA;
D;U;I