C;Z;I;0;0;0;0;0
D;Z;O;0;0;0;0;0
D;Z;P;0;0;0;0;0
?;A;?;0;0;0;0;0
D;A;P;0;0;0;0;0
S;A;P;K;0;0;0;0
S;A;P;O;S;0;0;0
S;C;C;C;O;O;O;0

test: 

DDD;SSS;CCCC;AAAA;ZZZ;PPPP;OOOOO;IKS;
C;R;M