Y;0;R;0;0;O;0;0
N;C;Ó;0;0;W;0;0
O;Z;?;0;0;N;0;0
L;A;¯;0;£;A;0;0
E;R;O;Z;Y;J;0;0
I;N;W;£;?;Y;T;0
Z;Y;Y;?;Y;C;I;Y
B;I;A;B;U;R;Y;S

kolory: 

BURY;BIA£Y;SIWY;SZARY;Z£OTY;ZÓ£TY;CZARNY;ZIELONY;RÓ¯WY;CYJAN;
C;R;M